[[[[[[[[[[[[[[[[[[[[[[[[[[[[[[[[[[[[[[[[[[[[[[[[[[[[[[[[[[[
[[[[[[[[[[[[[[[[[[[[[[[[[[[[[[[[[[[[[[[[[[[[[[[[[[[[[[[[[[[
E------------[[[[[[[[[--------------[[[[[[[[[------------[[
]]]]---------]]]]]]]]]--------------[[[[[[[[[------------[[
]]]]---------]]]]]]]]]-----------------------------------[[
]]]]---------]]]]]]]]]--------------[[[[[[[[[------------[[
]]]]---------]]]]]]]]]--------------[[[[[[[[[------------[[
]]]]---------]]]]]]]]]--------------]]]]]]]]]------------]]
]]]]---------]]]]]]]]]--------------]]]]]]]]]------------]]
]]]]]]]]-]]]]]]]]]]]]]]]]]]]]-]]]]]]]]]]]]]]]]]]]]]]]-]]]]]
]]]]]]]]-]]]]]]]]]]]]]]]]]]]]-]]]]]]]]]]]]]]]]]]]]]]]-]]]]]
]]]------------]]]]]]]]]]]]]]-]]]]]]]]]]]]]]]]]]]]]]]-]]]]]
]]]------------]]]]]]]]--------------]]]]]]]]------------]]
]]]------------]]]]]]]]--------------]]]]]]]]------------]]
]]]------------]]]]]]]]--------------]]]]]]]]------------]]
]]]------------]]]]]]]]--------------]]]]]]]]------------]]
]]]------------]]]]]]]]--------------]]]]]]]]------------]]
]]]------------]]]]]]]]--------------]]]]]]]]------------]]
]]]]]]]]-]]]]]]]]]]]]]]]]]]]]]-]]]]]]]]]]]]]]]]]]]]-]]]]]]]
]]]]]]]]-]]]]]]]]]]]]]]]]]]]]]-]]]]]]]]]]]]]]]]]]]]-]]]]]]]
]]]------------]]]]]]]]--------------]]]]]]]]------------]]
]]]------------]]]]]]]]--------------]]]]]]]]------------]]
]]]------------]]]]]]]]--------------]]]]]]]]------------]]
]]]------------]]]]]]]]--------------]]]]]]]]]----------]]]
]]]----------------------------------]]]]]]]]]]--------]]]]
]]]------------]]]]]]]]--------------]]]]]]]]]]]------]]]]]
]]]------------]]]]]]]]--------------]]]]]]]]]]]]----]]]]]]
]]]------------]]]]]]]]]]]]]]]]]]]]]]]]]]]]]]]]]]]P]]]]]]]]
]]]]]]]]]]]]]]]]]]]]]]]]]]]]]]]]]]]]]]]]]]]]]]]]]]E]]]]]]]]