] ] ] ] ] ] ] ] ] ] ] ] ] ] ] ] ] ] ] ] ] /
] ] ] ] ] ] ] ] ] ] ] ] ] ] ] ] ] ] ] ] ] /
] ] ] ] ] ] ] ] ] ] ] ] ] ] ] ] ] ] ] ] ] /
] ] ] ] ] ] ] ] ] ] ] ] ] ] ] ] ] ] ] ] ] /
] ] ] ] ] ] ] ] ] ] ] ] ] ] ] ] ] ] ] ] ] /
] ] ] - - - - - - - - - - - - - - ] ] ] ] /
] ] ] - - - - - - - - - - - - - - ] ] ] ] /
] ] ] - - - - - - - - - - - - - - ] ] ] ] /
] ] ] - - - p - - - - - - - - - - ] ] ] ] /
] ] ] - - - - - - - - - - - - - - ] ] ] ] /
- - - - - - - - - - - - - - - - - ] ] ] ] /
] ] ] - - - - - - - - - - - - - - ] ] ] ] /
] ] ] - - - - - - - - - - - - - - ] ] ] ] /
] ] ] - - - - - - - - - - - - - - ] ] ] ] /
] ] ] - - - - - - - - - - - - - - ] ] ] ] /
] ] ] - - - - - - - - - - - - - - ] ] ] ] /
] ] ] ] ] ] ] ] ] ] ] ] ] ] ] ] ] ] ] ] ] /
] ] ] ] ] ] ] ] ] ] ] ] ] ] ] ] ] ] ] ] ] /
] ] ] ] ] ] ] ] ] ] ] ] ] ] ] ] ] ] ] ] ] /
] ] ] ] ] ] ] ] ] ] ] ] ] ] ] ] ] ] ] ] ] /

