]]]]]]]]]]]]]]]]]]]]]
]]]]]]]]]]]]]]]]]]]]]
]]]]]]]]]]]]]]]]]]]]]
]]]]]]]]]]]]]]]]]]]]]
]]]--------------]]]]
]]]p-------------]]]]
]]]--------------]]]]
]]]--------------]]]]
]]]--------------]]]]
E----------------]]]]
]]]--------------]]]]
]]]--------------]]]]
]]]--------------]]]]
]]]--------------]]]]
]]]--------------]]]]
]]]]]]]]]]]]]]]]]]]]]
]]]]]]]]]]]]]]]]]]]]]
]]]]]]]]]]]]]]]]]]]]]
]]]]]]]]]]]]]]]]]]]]]

