]]]]]]]]]]]]]]]]]]]]]
]]]]]]]]]]]]]]]]]]]]]
]]]]]]]]]]]]]]]]]]]]]
]]]]]]]]]]]]]]]]]]]]]
]]]--------------]]]]
]]]--------------]]]]
]]]--------------]]]]
]]]--------------]]]]
]]]--------------]]]]
E---------p------]]]]
]]]--------------]]]]
]]]--------------]]]]
]]]--------------]]]]
]]]--------------]]]]
]]]--------------]]]]
]]]]]]]]]]]]]]]]]]]]]
]]]]]]]]]]]]]]]]]]]]]
]]]]]]]]]]]]]]]]]]]]]
]]]]]]]]]]]]]]]]]]]]]

